




111111111111111111111111111
1CPCCCCCCCCCCCCCCCCCCCCCCC1
1CE100000000000000000000011
111111111111111111111111111













