




1111111111111
1000000000001
11100P100E001
1CC111C000011
100011E000011
1000000000011
1111111111111













