




11111
100P1
10CE1
11111













