




11111111
100000P1
10C000E1
100000E1
11111111













