




1111111111111
100P000000001
111000100E001
1CC111C000011
1000110000011
1000000000011
1111111111111













