




11111111
100000P1
1000C0E1
1000C0E1
11111111













