111111111
10C00E001
1P0000C01
100000001
111111111

