




111111111111111111111111111111111111111111111111111111111111111111
100P1E000000000000000000000000000000000000000000000000000000000001
100010000000000000000000000000000000000000000000000000000000000001
1C0000C00000000000000000000000000000000000000000000000000000000001
111111111111111111111111111111111111111111111111111111111111111111













