1111111111111111111111111111111111111111
1100000000P0C000000000000000000000000001
1110111111000000000000000000000000000001
11100111110000000000011111000000000C0001
1110011111000000000001111100000000000001
1110011111000000000001111100000000000001
1110000000000000000000000000000000000001
10C0000000000000000000000000000000000001
1111111111111110111111110111111111110011
1000000000000000111111110000000C00000001
1000000000000000111111111111111111111101
1000000000000000111111111111111111111E01
1000000000000000000000000000100000000001
1011111111011111111111000000100000000001
1011000000000000C00E11000000100000000001
10111C0000000000000111000000100000000001
1011111111111111111111000000100000000001
1000000000000000000000000000100000000001
1000000000000000000000000000100000000001
1000000000000000000000000000100000000001
10000000000000000000000000000000000000E1
1111111111111111111111111111111111111111

